F 255,0,0
C 0,0,0

NO textures/main_tex/s.xpm
SO textures/main_tex/w.xpm
WE textures/main_tex/n.xpm
EA textures/main_tex/e.xpm

1111111111111111111
10S1001001001000001
100100D000000001001
1021001001111101111
1201111000001001001
100D00000000D001001
1021111111111001001
1111000000000001011
1000000001000001001
1111111111111111111