NO ./textures/wall_1.xpm
SO ./textures/wall_2.xpm
WE ./textures/wall_3.xpm
EA ./textures/wall_4.xpm

S ./textures/sprite_1.xpm
DO ./textures/wood.xpm

F 220,100,0
C 225,30,0

111111111111
100020000001
100000000001
100002000201
100000000001
10000N000001
111111111111
