NO ./textures/wall_1.xpm
SO ./textures/wall_2.xpm
WE ./textures/wall_3.xpm
EA ./textures/wall_4.xpm

S ./textures/sprite_1.xpm
DO ./textures/wood.xpm

F 255,0,0
C 0,0,0

111111111111111111
100000000000000001
100000200000000001
10000000001D100001
100000000000000001
100002000000000001
100000001D10000001
100000000000000001
1000000000000000N1
111111111111111111
