F 76,76,76
C 99,99,99

NO textures/wall_1.xpm
SO textures/wall_2.xpm
WE textures/wall_3.xpm
EA textures/wall_4.xpm

DO textures/wood.xpm

1111111111111111111
10S1001001001000001
11D100D000000001001
1001001001111101111
1001111000001001001
100D00000000D001001
1001111111111001001
1111000000000001011
1000000001000001001
1111111111111111111