
NO textures/main_tex/n.xpm
SO textures/main_tex/s.xpm
WE textures/main_tex/w.xpm
EA textures/main_tex/e.xpm



F 100,100,100
C 0,0,0

111111111111111111
100000000000000001
100000000000000001
10000000001D100001
100000000000000001
100000000000000001
100000001D10000001
100000000000000001
1000000000000000N1
111111111111111111
