NO ./textures/wall_1.xpm
SO ./textures/wall_2.xpm
WE ./textures/wall_3.xpm
EA ./textures/wall_4.xpm

F 220,100,0
C 225,30,0

1111111111111111
1000000D00000001
1000200000020001
1000000D00000001
1111D1111111D111
100000000N000001
100020000000D001
1111111111111111
