F 36 ,185 , 200
C 36 ,185 , 255
NO textures/wall_1.xpm
SO textures/wall_2.xpm
WE textures/wall_3.xpm










































                                                                                                          g

































EA textures/wall_4.xpm

11111111111111111111111111
111000001001000011
1000000001000001001
1001001001111101111
1001111000000100101
100000000W000001001
1001111111111001001
1111000000000001011
1000000001000001001                                  
1111111111111111111                                                                 
 
