 SO ./path_to_the_south_texture.xpm.xpm
WE ./path_to_the_west_texture.xpm

EA ./path_to_the_east_texture.xpm


NO ./path_to_the_east_texture.xpm



F 220,100,00000000000000000
C 225,30,123

        11111111111111111111111111
        1000000000110000000000001
        1011000001110000000000001
        1001000000000000000000001
111111101011000001110000000000001
100000000011000001110111111111111
1111011111111101111111110001
111101     1110111     100001
11011111111101011111111110001
10000000000000001100000010001
10000000000000001101010010001
11000001110101011111011110N01111111111
11110111 1110101 101111010001
11111111 1111111 111111111111