   WE                            textures/wolfenstein/eagle.xpm 
NO      textures/wolfenstein/grey_stone.xpm



SO textures/wolfenstein/red_brick.xpm

F   69, 222, 26


C 235, 198, 52

               EA textures/wolfenstein/mossy.xpm

1111
10011
1111
