NO textures/bluestone.xpm
SO textures/wall_2.xpm
WE textures/sky_1.xpm
EA textures/pillar.xpm

F 255,255,255
C 255,0,0

        1111111111111111111111111
        1000000000110000000000001
        1011000001110000000000001
        1001000000000000000000001
111111111011000001110000000000001
100000000011000001110111111111111
111101111111110111010000010001 
11110111111111011101010010001  
11000000110101011100000010001
10000000000000001100000010001
1000000000000000110101000001
11000001110101011111011110N0111
11110111111101011101111010001
11111111111111111111111111111