SO textures/simonkraft/respawn_anchor_side2.xpm
WE textures/simonkraft/respawn_anchor_side3.xpm

EA textures/simonkraft/wet_sponge.xpm


NO textures/simonkraft/respawn_anchor_side0.xpm



F 220,100,0
C 225,30,123

111111111111111
10000000N000001
101111011111101
101000010000101
101011110110101
101000000010101
101011111010101
101000001010101
101011101010101
101000001000101
101111101111101
100000000000001
111111111111111