
NO textures/main_tex/n.xpm
SO textures/main_tex/s.xpm
WE textures/main_tex/w.xpm
EA textures/main_tex/e.xpm

F 0,32,0
C 120,0,16

 1111111        111111111
110000011      10000000001
100000001     1000000000001
 1000001     100000000000001
  11011      1000000000000001
   101        1000000100000001
   101         100001 100000001
   101111111111111D111111D1111
   10D00000000D00000000000001
   1011111111111000000000001
   101         100000000001
   101        100000000001
  11011      100000001111
 1000001     1000000N1001
100000001     10000001001
110000011      100000D001
 1111111        111111111