NO textures/simonkraft/respawn_anchor_side0.xpm
EA textures/simonkraft/respawn_anchor_side2.xpm
SO textures/simonkraft/respawn_anchor_side4.xpm
WE textures/simonkraft/respawn_anchor_side3.xpm

C 35,19,73
F 15,6,40

1111
1001
10p1
1111
