R 640 480
NO textures/wall_1.xpm
SO textures/wall_2.xpm
WE textures/wall_3.xpm
EA textures/wall_4.xpm
S textures/sprite_1.xpm
F 30,30,30
C 210,200,180

11111
1N0E1
11111
