R 800 600
NO textures/wall_1.xpm
SO textures/wall_2.xpm
WE textures/wall_3.xpm
EA textures/wall_4.xpm
S textures/sprite_1.xpm
F 220,100,0
C 10,150,200

111111
1N0021
111111
