NO textures/bluestone.xpm
SO textures/wall_2.xpm
WE textures/sky_1.xpm
EA textures/pillar.xpm

F 255,255,255
C 255,0,0

        111111111111111111111111111111111111
        100000000000000000000000000000000001
        100000000000000000000000000000000001
        100000000000000000000000000000000001
        100000000000000000000000000000000001
        1011000001110000000000000000000000N1
        1111111111111111111111111111111111111